xxxxxxx
x.BTB.x
S.xxx.Z
x.B.B.x
xxx.xxx
xOOBOOx
xTxxxTx
xxxxxxx